Utah official symbol Celestial Pivot, Utah official symbol Beehive Cluster	no
First premiership of Mahathir Mohamad has cabinet First Mahathir cabinet, First premiership of Mahathir Mohamad has cabinet Fifth Mahathir cabinet	yes
Utah official symbol Celestial Pivot, Utah official symbol Populus tremula	no
Apple M1 Max microarchitecture Apple Firestorm, Apple M1 Max microarchitecture Apple Icestorm	yes
Belgium highest judicial authority Belgian Court of Cassation, Belgium highest judicial authority Council of State	no
Catalonian immigration to Mexico start point Spain, Catalonian immigration to Mexico start point Catalonia	yes
Trophies dataset distribution music download, Trophies dataset distribution vinyl record	no
German has grammatical mood imperative, German has grammatical mood indicative	no
Kasuliyili Senior High School category for alumni of educational institution politician, Kasuliyili Senior High School category for alumni of educational institution lawyer	yes
Urnerboden exclave of canton of Uri, Urnerboden exclave of Spiringen	no
motorsport topic's main Wikimedia portal Portal:Motorsport, motorsport topic's main Wikimedia portal Portal:Motorcycle racing	yes
tenoxicam significant drug interaction aspirin, tenoxicam significant drug interaction chlorthalidone	no
Advance Wars: Dual Strike CERO rating A (All ages), Advance Wars: Dual Strike CERO rating All Ages	yes
ASPIC statistical unit used region of France, ASPIC statistical unit used department of France	no
Le monde nous appartient RCQ classification G, Le monde nous appartient RCQ classification 13+	yes
Sparrow undercarriage conventional landing gear, Sparrow undercarriage tricycle gear	no
First premiership of Mahathir Mohamad has cabinet Fifth Mahathir cabinet, First premiership of Mahathir Mohamad has cabinet First Mahathir cabinet	yes
Australia aircraft registration prefix VJ, Australia aircraft registration prefix VI	no
Regatta at Sainte-Adresse copyright status public domain, Regatta at Sainte-Adresse copyright status copyrighted	yes
Dunghutti totem Mantodea, Dunghutti totem Australian Raven	yes
The Pianist EIRIN film rating G, The Pianist EIRIN film rating PG12	yes
Pantaenus time period Roman Empire, Pantaenus time period Hellenistic period	no
Online Database of Tibetan Living Buddhas online access status location restricted to country of publication, Online Database of Tibetan Living Buddhas online access status registration required	yes
Swedish language regulatory body Swedish Academy, Swedish language regulatory body Institute for the Languages of Finland	no
Purshia tridentata NatureServe conservation status secure, Purshia tridentata NatureServe conservation status apparently secure	yes
Alucard superhuman feature or ability telekinesis, Alucard superhuman feature or ability telepathy	no
St. Margaret Senior High School motto Hardworker, St. Margaret Senior High School motto prayer	yes
Criminal Minds list of episodes list of Criminal Minds episodes, Criminal Minds list of episodes list of Criminal Minds episodes (from season 8 on)	yes
Slackware update method slackpkg, Slackware update method Pkgtool	no
Rotten Tomatoes topic's main template Template:Rotten Tomatoes, Rotten Tomatoes topic's main template Template:Rotten Tomatoes person	yes
National Library of Israel content partnership category Category:Images donated as part of the collaboration project between National Library of Israel and Wikimedia Israel, National Library of Israel content partnership category Category:GLAM National Library of Israel	yes
Gmork appears in the form of Canis lupus, Gmork appears in the form of human	no
Kosmos 12 space launch vehicle Vostok-2, Kosmos 12 space launch vehicle Vostok	yes
Borsele contains settlement Hoedekenskerke, Borsele contains settlement Koekoek	no
square root image of function Riemann sphere, square root image of function complex plane	yes
Cassa di Risparmio di Voghera legal form investment, Cassa di Risparmio di Voghera legal form savings bank	yes
Deadpool Hong Kong film rating Category IIB, Deadpool Hong Kong film rating Category III	yes
Europeana entity property usage tracking category Category:Pages using Wikidata property P7704, Europeana entity property usage tracking category Category:Europeana	yes
Centre for Eastern European Studies substitute/deputy/replacement of office/officeholder Adam Eberhardt, Centre for Eastern European Studies substitute/deputy/replacement of office/officeholder Helena Krasowska	yes
Guglielmo voice type bass, Guglielmo voice type baritone	no
WikiTeam interested in wiki, WikiTeam interested in digital preservation	no
Luxembourgish indigenous to Luxembourg, Luxembourgish indigenous to Luxembourg	no
Chiquitita modified version of Three Wise Guys, Chiquitita modified version of Chiquitita Angelina	no
benedictive grammatical option indicates wish, benedictive grammatical option indicates blessing	no
Japanese castle category for the view from the item Category:Views from castles in Japan, Japanese castle category for the view from the item Category:Views from castles of Japan	yes
Vim supports programming language HTML, Vim supports programming language Go	no
anthrax disease transmission process airborne transmission, anthrax disease transmission process contact transmission	no
The Crow MTRCB rating R-16, The Crow MTRCB rating R-18	yes
John Wick: Chapter 2 BBFC rating 15 certificate, John Wick: Chapter 2 BBFC rating 18 certificate	yes
official website corresponding template Template:Wikidata/P856, official website corresponding template Template:Official website	yes
Antigua and Barbuda anthem Fair Antigua, We Salute Thee, Antigua and Barbuda anthem God Save the King	yes
Quechua category for films in this language Category:Southern Quechua-language films, Quechua category for films in this language Category:Quechua-language films	yes
勺 grade of kanji jōyō kanji, 勺 grade of kanji jinmeiyō kanji	yes
Narrhalla Achern 1873 motto Narri – Narro, Narrhalla Achern 1873 motto Helau	yes
RRC 522/1 central bank/issuer Mark Antony, RRC 522/1 central bank/issuer Lucius Munatius Plancus	yes
Saraswati domain of saint or deity music, Saraswati domain of saint or deity art	no
Eugen Weidmann manner of death capital punishment, Eugen Weidmann manner of death public execution	yes
Bruges subreddit bruges, Bruges subreddit brugge	no
geophysics is the study of Earth, geophysics is the study of geological process	no
kelvin measured physical quantity thermodynamic temperature, kelvin measured physical quantity superconduction transition temperature	no
Allies of the First World War opposite of Germany, Allies of the First World War opposite of Austria-Hungary	yes
First premiership of Mahathir Mohamad has cabinet Fifth Mahathir cabinet, First premiership of Mahathir Mohamad has cabinet Fourth Mahathir cabinet	yes
Adalbert canonization status saint, Adalbert canonization status Catholic saint	no
geophysics is the study of Earth, geophysics is the study of magmatism	no
Legal Research Development online access status paywall, Legal Research Development online access status free to read	yes
Latin has grammatical case vocative case, Latin has grammatical case nominative case	no
vanadinite color yellow, vanadinite color brown	no
Eos iconographic symbol saffron, Eos iconographic symbol cloak	no
Academy Award for Best Actor category for recipients of this award Category:Best Actor Academy Award winners, Academy Award for Best Actor category for recipients of this award Category:Films featuring a Best Actor Academy Award–winning performance	yes
evolution has immediate cause survival of the fittest, evolution has immediate cause selective breeding	no
Adelegg highest point Ursersberg, Adelegg highest point Hauptmannsberg	no
aescin has active ingredient escin Ia, aescin has active ingredient saponin	no
Ulysses space tug PAM-S, Ulysses space tug Inertial Upper Stage	yes
Wario wears shoe, Wario wears belt	no
Burlakov case court Panama, Burlakov case court United States	yes
Camino copyright license GNU General Public License, Camino copyright license GNU Lesser General Public License	no
Kasuliyili Senior High School category for alumni of educational institution lawyer, Kasuliyili Senior High School category for alumni of educational institution politician	yes
Grandpaw Mort Barker animal breed basset hound, Grandpaw Mort Barker animal breed beagle	yes
praporshchik next higher rank starshy praporshchik, praporshchik next higher rank junior lieutenant	no
Segezhskoe outflows Segezha, Segezhskoe outflows Obzhanka	no
price type of unit for this property fictional currency, price type of unit for this property currency	no
Arabic language regulatory body Academy of the Arabic Language in Cairo, Arabic language regulatory body Iraqi Academy of Sciences	no
sine mathematical inverse cosecant, sine mathematical inverse arcsine	yes
Earth child astronomical body Hubble Space Telescope, Earth child astronomical body Blue Ring Pathfinder	no
humanities is the study of history, humanities is the study of religion	no
Vantaa Parish Union diocese Diocese of Helsinki, Vantaa Parish Union diocese Diocese of Borgå	yes
official website corresponding template Template:Official URL, official website corresponding template Template:Wikidata/P856	yes
sorghum natural product of taxon Sorghum, sorghum natural product of taxon Sorghum bicolor	no
National Heroes Cemetery in Rwanda category for people buried here Fred Rwigyema, National Heroes Cemetery in Rwanda category for people buried here Félicité Niyitegeka	yes
Dinorwig Power Station reservoir created Llyn Peris, Dinorwig Power Station reservoir created Marchlyn Mawr	yes
Isfahan economy of topic economy of Isfahan, Isfahan economy of topic Economy in Isfahan	yes
Anatoly Nikolaevich Petrov military branch navy, Anatoly Nikolaevich Petrov military branch Soviet Navy	yes
Project 5155 moved by General Administration of Press and Publication, Project 5155 moved by Publicity Department of the Chinese Communist Party	yes
Machikado Museums is metaclass for museum, Machikado Museums is metaclass for art museum	yes
Imperial Noble Consort Shujia Eight Banner register Manchu Plain Yellow Banner, Imperial Noble Consort Shujia Eight Banner register Bondservant Division of Plain Yellow Banner	yes
1984 Balkan Bulgarian Tupolev Tu-134 crash start point Berlin, 1984 Balkan Bulgarian Tupolev Tu-134 crash start point Berlin Schönefeld Airport	yes
Hintertreppe director of photography Willy Hameister, Hintertreppe director of photography Karl Hasselmann	no
Apple M1 Pro microarchitecture Apple Icestorm, Apple M1 Pro microarchitecture Apple Firestorm	yes
Base −1 ± i radix −1−i, Base −1 ± i radix −1+i	yes
Japan has seal, badge, or sigil national seal, Japan has seal, badge, or sigil Imperial Seal of Japan	yes
Daewoo organizational divisions Daewoo Motors, Daewoo organizational divisions Mirae Asset Securities	no
Order of the Wendish Crown donated by Frederick William, Grand Duke of Mecklenburg-Strelitz, Order of the Wendish Crown donated by Frederick Francis II	yes
Tbilisi capital of Georgia, Tbilisi capital of Military Council	no
Canada diplomatic relation Hungary, Canada diplomatic relation Spain	no
spaceflight practiced by astronaut, spaceflight practiced by cosmonaut	no
water has characteristic color, water has characteristic odorlessness	no
Vim supports programming language JavaScript, Vim supports programming language C	no
Prussia capital Berlin, Prussia capital Königsberg	yes
official website corresponding template Template:Wikidata/P856, official website corresponding template Template:Official URL	yes
Hungarian Rhapsody: Queen Live in Budapest Australian Classification G, Hungarian Rhapsody: Queen Live in Budapest Australian Classification M	yes
lepo designed to carry wire rope, lepo designed to carry Synthetic rope	no
Global Defence Force CERO rating CERO 12, Global Defence Force CERO rating B (Ages 12 and up)	yes
weapon family is metaclass for weapon, weapon family is metaclass for weapon model	yes
Kuzco handedness left-handedness, Kuzco handedness right-handedness	yes
fuang currency symbol description 方, fuang currency symbol description asterisk	yes
Valukarama statement is subject of Balukaram Sub Post Office, Valukarama statement is subject of UMS BALUKARAM	no
AirLapse industry Internet, AirLapse industry tourism industry	no
Casio Exilim EX-P600 category for pictures taken with this camera Category:Taken with Casio Exilim EX-P600, Casio Exilim EX-P600 category for pictures taken with this camera Category:Taken with Casio Exilim Pro EX-P600	yes
Japan right to vote universal suffrage, Japan right to vote age limit	no
Lrp dual to ilvL, Lrp dual to adhE	no
Nayadic port of registry Groningen, Nayadic port of registry Willemstad	no
Shaw University category for employees of the organization Category:Presidents of Shaw University, Shaw University category for employees of the organization Category:Shaw University faculty	yes
Betacoronavirus 1 replaced synonym (for nom. nov.) Human coronavirus OC43, Betacoronavirus 1 replaced synonym (for nom. nov.) Porcine hemagglutinating encephalomyelitis virus	yes
Validator depends on software PHP, Validator depends on software MediaWiki	no
lansoprazole legal status (medicine) prescription drug, lansoprazole legal status (medicine) boxed warning	no
Eos iconographic symbol saffron, Eos iconographic symbol tiara	no
outlier test method Mahalanobis distance, outlier test method anomaly detection	no
European Union legislative body European Parliament, European Union legislative body Council of the European Union	yes
Agworok people economy of topic rice, Agworok people economy of topic yam	yes
cube base equilateral triangle, cube base square	no
Ireland member of European Union, Ireland member of World Meteorological Organization	no
Betacoronavirus 1 replaced synonym (for nom. nov.) Human coronavirus OC43, Betacoronavirus 1 replaced synonym (for nom. nov.) Bovine coronavirus	yes
Judaism foundational text Talmud, Judaism foundational text Torah	no
White-bellied Rat Wildlife Protection Act 1972 (India) schedule Schedule V of Wildlife Protection Act, 1972, White-bellied Rat Wildlife Protection Act 1972 (India) schedule Schedule IV of Wildlife Protection Act, 1972	yes
Charmed list of characters list of Charmed villains, Charmed list of characters list of Charmed characters	yes
influenza disease transmission process direct transmission, influenza disease transmission process airborne transmission	no
Aureolus praenomen Marcus, Aureolus praenomen Manius	no
Vincent Cassel filmography La Haine, Vincent Cassel filmography Irréversible	yes
House of the Dead Hong Kong film rating Category IIB, House of the Dead Hong Kong film rating Category III	yes
Caroline Peters list of works Beautiful Women, Caroline Peters list of works Princess	yes
LoC HABS/HAER/HALS place ID corresponding template Template:HABS, LoC HABS/HAER/HALS place ID corresponding template Template:HAER	yes
Countess Ludwika Tyzenhauz family House of Tiesenhausen, Countess Ludwika Tyzenhauz family House of Grabowski (Oksza)	yes
typology of the Etruscans mythological theme is metaclass for Greek mythology, typology of the Etruscans mythological theme is metaclass for theme	yes
Aygün Kazimova category of associated people Snoop Dogg, Aygün Kazimova category of associated people David Vendetta	yes
Doctor Who list of episodes list of Doctor Who episodes (2005–present), Doctor Who list of episodes list of special Doctor Who episodes (since 2005)	yes
Olsztyn Cathedral category for the exterior of the item Category:Exterior of the Olsztyn Cathedral at night, Olsztyn Cathedral category for the exterior of the item Category:Exterior of the Olsztyn Cathedral	yes
Prince Albert of York (1895-1952), later King George VI pendant of Princess Mary of York (1897-1965), later Princess Royal and Countess of Harewood, Prince Albert of York (1895-1952), later King George VI pendant of Prince Edward of York (1894-1972), later King Edward VIII	yes
evolution has immediate cause survival of the fittest, evolution has immediate cause natural selection	no
Dota Underlords takes place in fictional universe Dota 2, Dota Underlords takes place in fictional universe Dota universe	yes
defendant opposite of prosecutor, defendant opposite of plaintiff	no
Amphibia main food source insect, Amphibia main food source worm	no
Neutrino home world Neutrino homeworld, Neutrino home world Neutrino	no
Mindaugas noble title king, Mindaugas noble title Grand Duke of Lithuania	no
Dan activator of ttdR, Dan activator of ttdB	no
Taiwan highest judicial authority Justice of the Judicial Yuan, Taiwan highest judicial authority Supreme Administrative Court	yes
Vim SourceForge project vim, Vim SourceForge project vimdoc	no
Goh has pet Fletchling, Goh has pet Ariados	no
Ramarama UNESCO language status 2 vulnerable, Ramarama UNESCO language status 5 critically endangered	yes
omniverse named after Universe, omniverse named after Omnes	no
Zaanland port of registry Amsterdam, Zaanland port of registry Panama City	no
Manhole Dog animal breed beagle, Manhole Dog animal breed French Bulldog	yes
Chiococca alba NatureServe conservation status secure, Chiococca alba NatureServe conservation status apparently secure	yes
Die Heiligen Georg und Mauritius is verso of Die Heiligen Genoveva und Lucia, Die Heiligen Georg und Mauritius is verso of Die Heiligen Margareta und Ottilia	yes
Downfall after a work by Albert Speer, Downfall after a work by Joachim Fest	no
People's Republic of China top-level Internet domain .中国, People's Republic of China top-level Internet domain .cn	yes
museum shop typically sells book, museum shop typically sells decorative poster	yes
Russia designated as terrorist by Slovakia, Russia designated as terrorist by Lithuania	no
Gardens of the Rector’s fountain moved by Àmbit metropolità de Barcelona, Gardens of the Rector’s fountain moved by Sant Climent de Llobregat city council	yes
Gunnhildr Sveinsdóttir family Earls of Lade, Gunnhildr Sveinsdóttir family Hlaðir dynasty	yes
Ireland member of European Union, Ireland member of International Bank for Reconstruction and Development	no
Switzerland language used French, Switzerland language used German	no
Duke Nukem II USK rating USK 0, Duke Nukem II USK rating USK 12	yes
paragonimiasis anatomical location lung, paragonimiasis anatomical location abdomen	no
⺀ radical Kangxi radical 3 (⼂), ⺀ radical Kangxi radical 15 (⼎)	yes
Davis Cup topic's main template Template:Davis Cup player, Davis Cup topic's main template Template:Davis Cup	yes
Spore game mechanics procedural generation, Spore game mechanics open world	no
bort appears in the form of gravel, bort appears in the form of nanoparticle	no
Wuhan Huanan Seafood Wholesale Market typically sells snake, Wuhan Huanan Seafood Wholesale Market typically sells fish as food	yes
Aygün Kazimova category of associated people Snoop Dogg, Aygün Kazimova category of associated people Alim Qasimov	yes
Nulytely has active ingredient sodium chloride, Nulytely has active ingredient sodium bicarbonate	no
Portal:Military Wikimedia portal's main topic war, Portal:Military Wikimedia portal's main topic military	yes
The House of the Dead ELSPA rating 3+, The House of the Dead ELSPA rating 11+	yes
Primal Fear NMHH film rating Category IV, Primal Fear NMHH film rating Category V	yes
Christmas place of publication Canada, Christmas place of publication United States	no
Portal:Washington, D.C. Wikimedia portal's main topic Washington, D.C., Portal:Washington, D.C. Wikimedia portal's main topic District of Columbia	yes
Carex macloviana NatureServe conservation status secure, Carex macloviana NatureServe conservation status apparently secure	yes
Bloch MB.220 wing configuration cantilever, Bloch MB.220 wing configuration monoplane	yes
Loire tributary Divatte, Loire tributary Bresbre	no
Czechoslovakia central bank National Bank of Czechoslovakia, Czechoslovakia central bank State Bank of Czechoslovakia	no
Balistrad intended public Haiti, Balistrad intended public intellectual	no
Czechoslovakia legislative body National Assembly of the Czechoslovak Republic, Czechoslovakia legislative body Provisional National Assembly of Czechoslavakia	no
Iowa lowest point Mississippi River, Iowa lowest point Des Moines River	no
omphacite space group space group P2/n, omphacite space group space group C2/c	yes
岐 grade of kanji jōyō kanji, 岐 grade of kanji grade 4 kyōiku kanji	yes
⺀ radical Kangxi radical 3 (⼂), ⺀ radical CJK radical repeat (⺀)	yes
Kingdom of France legislative body Estates General, Kingdom of France legislative body National Constituent Assembly	yes
Sweden highest judicial authority Supreme Administrative Court of Sweden, Sweden highest judicial authority Supreme Court of Sweden	no
Khortytsia stated in Soviet encyclopedia of the history of Ukraine, Khortytsia stated in Ukrainian Soviet Encyclopedia	no
Raven superhuman feature or ability telekinesis, Raven superhuman feature or ability flight	no
bass guitar lowest note C♯, bass guitar lowest note D	yes
Heat RCQ classification 16+, Heat RCQ classification 13+	yes
aerugite streak color light blue green, aerugite streak color bright green	no
Gansu party chief representative Zhang Desheng, Gansu party chief representative Su Rong	no
KCRW radio format Eclecticism, KCRW radio format public radio	no
National Heroes Cemetery in Rwanda category for people buried here Agathe Uwilingiyimana, National Heroes Cemetery in Rwanda category for people buried here Félicité Niyitegeka	yes
aspirin medical condition treated myocardial infarction, aspirin medical condition treated osteoarthritis	no
Abraham worshipped by Islam, Abraham worshipped by Judaism	no
Halictidae is pollinator of Aetheorhiza bulbosa, Halictidae is pollinator of Eriogonum latifolium	no
libcurl manifestation of HTTP, libcurl manifestation of Simple Mail Transfer Protocol	no
Fourvière category for the view of the item Category:Views of Fourvière, Fourvière category for the view of the item Category:Views of Lyon from Fourvière	yes
Alien 3 BBFC rating 15 certificate, Alien 3 BBFC rating 18 certificate	yes
Anadyr Köppen climate classification oceanic climate, Anadyr Köppen climate classification subarctic climate	no
Dee Gordon handedness left-handedness, Dee Gordon handedness right-handedness	yes
Italian has grammatical mood infinitive, Italian has grammatical mood indicative	no
One Direction: This Is Us NMHH film rating Category II, One Direction: This Is Us NMHH film rating Category I	yes
Female Figure Holding a Bridle [reverse] is verso of Elisabetta Gonzaga, died 1528, Duchess of Urbino, Wife of Guidobaldo I 1489 [obverse], Female Figure Holding a Bridle [reverse] is verso of Elisabetta Gonzaga, died 1526, Duchess of Urbino, Wife of Guidobaldo I 1489 [obverse]	yes
Grjotgard Herlaugsson family Earls of Lade, Grjotgard Herlaugsson family Hlaðir dynasty	yes
Wikibase depends on software PHP, Wikibase depends on software MediaWiki	no
kitsch has contributing factor Industrial Revolution, kitsch has contributing factor urbanization	no
2024 EBSA European Snooker Championship tournament type championship, 2024 EBSA European Snooker Championship tournament type qualification tournament	yes
Parodia replaced synonym (for nom. nov.) Wigginsia, Parodia replaced synonym (for nom. nov.) Malacocarpus Salm-Dyck (1850) non Fisch. & C.A.Mey. (1843)	yes
formosulfathiazole polymer of sulfathiazole, formosulfathiazole polymer of formaldehyde	no
Francisco Javier de Elío manner of death capital punishment, Francisco Javier de Elío manner of death garrote	yes
1957 Modena Grand Prix fastest lap Luigi Musso, 1957 Modena Grand Prix fastest lap Jean Behra	yes
French has tense future perfect, French has tense present participle	no
A-001 space launch vehicle Little Joe, A-001 space launch vehicle Little Joe II	yes
Konak state of use proposed building or structure, Konak state of use in use	yes
spouse subproperty of significant person, spouse subproperty of relative	no
Dīwān ul-Lughat al-Turk copyright status public domain, Dīwān ul-Lughat al-Turk copyright status copyrighted	yes
French has tense pluperfect, French has tense future perfect	no
Lrp dual to dgcM, Lrp dual to aspA	no
Category:1562 in Spain category for the view of the item Category:View of Madrid (preparatory drawing), Anthonis van den Wijngaerde, Category:1562 in Spain category for the view of the item Category:View of Madrid (final drawing), Anthonis van den Wijngaerde	yes
Europeana entity property usage tracking category Category:Europeana, Europeana entity property usage tracking category Category:Pages using Wikidata property P7704	yes
WDWD radio format Christian radio, WDWD radio format talk radio	no
Boomer produced sound vomiting, Boomer produced sound burping	no
pyrrhotite crystal habit tabular, pyrrhotite crystal habit prismatic	no
Aygün Kazimova category of associated people David Vendetta, Aygün Kazimova category of associated people Snoop Dogg	yes
humanities is the study of history, humanities is the study of art	no
Google owner of Google Drive, Google owner of Jaiku	no
Haapa ‎breed belongs to taxon Bos mutus grunniensis, Haapa ‎breed belongs to taxon Bos grunniens	yes
Fetcher animal breed Labrador retriever, Fetcher animal breed beagle	no
siemens measured physical quantity electrical conductance, siemens measured physical quantity conductance for alternating current	no
German has grammatical mood subjunctive, German has grammatical mood imperative	no
Rotten Tomatoes topic's main template Template:Rotten Tomatoes, Rotten Tomatoes topic's main template Template:Rotten Tomatoes TV	yes
Great Diamond constellation Boötes, Great Diamond constellation Virgo	yes
human properties for this type image, human properties for this type occupation	no
Hastein subject named as Haftingus, Hastein subject named as Aflengo Nantolio	no
van den Branden de Reeth infix van den, van den Branden de Reeth infix de	yes
Gustav port of registry Hamburg, Gustav port of registry Potsdam	no
Prince Edward of York (1894-1972), later King Edward VIII pendant of Prince Albert of York (1895-1952), later King George VI, Prince Edward of York (1894-1972), later King Edward VIII pendant of Princess Mary of York (1897-1965), later Princess Royal and Countess of Harewood	yes
tenoxicam significant drug interaction aspirin, tenoxicam significant drug interaction bumetanide	no
square root codomain complex plane, square root codomain set of real numbers	yes
fuang currency symbol description 方, fuang currency symbol description F	yes
Robin member of the crew of Batmobile, Robin member of the crew of Batplane	no
ferrisepiolite streak color brown, ferrisepiolite streak color white	no
Tomka family infix -i, Tomka family infix de	yes
Irish has grammatical gender feminine, Irish has grammatical gender masculine	no
skull arterial supply internal carotid artery, skull arterial supply external carotid artery	no
Ulysses space tug Inertial Upper Stage, Ulysses space tug PAM-S	yes
gallium phosphate crystal system trigonal crystal system, gallium phosphate crystal system hexagonal crystal system	yes
closest string computational complexity NP-complete, closest string computational complexity NP-hardness	yes
Veneto docking port port of Chioggia, Veneto docking port Port of Venice	no
2005–06 La Liga rules for classification more points, 2005–06 La Liga rules for classification more head-to-head points	yes
Erich Mühsam manner of death capital punishment, Erich Mühsam manner of death homicide	yes
Nobel Peace Prize winner Barack Obama, Nobel Peace Prize winner Ludwig Quidde	yes
Google child organization/unit Waymo, Google child organization/unit SlickLogin	no
Loire tributary Divatte, Loire tributary Furan	no
loveringite crystal system trigonal crystal system, loveringite crystal system hexagonal crystal system	yes
Pégaso web interface software OpenMP, Pégaso web interface software Intel oneAPI Math Kernel Library	yes
Campanulaceae has fruit type pyxidium, Campanulaceae has fruit type berry	no
Kasuliyili Senior High School category for alumni of educational institution teacher, Kasuliyili Senior High School category for alumni of educational institution politician	yes
France located in or next to body of water Atlantic Ocean, France located in or next to body of water North Sea	no
Mathematica writable file format JSON, Mathematica writable file format tar	no
Darhan Eight Banner register Manchu Bordered Yellow Banner, Darhan Eight Banner register Manchu Plain Blue Banner	yes
Bulgarian has grammatical gender feminine, Bulgarian has grammatical gender neuter	no
Wikidata dataset distribution Wikidata RDF Dump Format, Wikidata dataset distribution Wikidata JSON dumps	no
tenoxicam significant drug interaction aspirin, tenoxicam significant drug interaction triamterene	no
Rothe coat of arms deer, Rothe coat of arms oak	no
Bionicle Heroes ESRB rating Everyone, Bionicle Heroes ESRB rating Teen	yes
Japan significant event World War II, Japan significant event Fukushima Daiichi nuclear disaster	no
Dan activator of ttdA, Dan activator of ttdT	no
France production statistics champagne, France production statistics cider	no
Canis different from dog, Canis different from jackal	no
Sastavci enclave within Zlatibor District, Sastavci enclave within Priboj Municipality	no
Latin has grammatical case ablative case, Latin has grammatical case genitive case	no
Rolando distributed by Apple, Rolando distributed by App Store	no
Eos iconographic symbol saffron, Eos iconographic symbol rose	no
Crayon Shin-chan list of episodes list of Crayon Shin-chan episodes, Crayon Shin-chan list of episodes list of Crayon Shin-chan episodes	yes
Ruhr lake on watercourse Hengsteysee, Ruhr lake on watercourse Harkortsee	no
Mathematica writable file format SVG, Mathematica writable file format text file	no
National Museum of World Cultures content partnership category Category:Files from the Nationaal Museum van Wereldculturen, National Museum of World Cultures content partnership category Category:Images from the Wereldmuseum Amsterdam	yes
Korean Empire central bank Daiichi Bank, Korean Empire central bank Bank of Korea	yes
Romana given name version for other gender Roman, Romana given name version for other gender Romano	no
Vim supports programming language HTML, Vim supports programming language JavaScript	no
Crayon Shin-chan list of episodes list of Crayon Shin-chan episodes, Crayon Shin-chan list of episodes List of Crayon Shin-chan episodes (1992–2001)	yes
aspic cuisine Russian cuisine, aspic cuisine Belarusian cuisine	no
Kasuliyili Senior High School category for alumni of educational institution politician, Kasuliyili Senior High School category for alumni of educational institution teacher	yes
MCSim determination method or standard Markov chain Monte Carlo, MCSim determination method or standard Bayesian statistics	no
Global Defence Force CERO rating CERO 12, Global Defence Force CERO rating C (Ages 15 and up)	yes
fuang currency symbol description F, fuang currency symbol description asterisk	yes
Veneto docking port Port of Lido, Veneto docking port port of Chioggia	no
National Heroes Cemetery in Rwanda category for people buried here Agathe Uwilingiyimana, National Heroes Cemetery in Rwanda category for people buried here Fred Rwigyema	yes
Golden Gate Bridge category for the view from the item Category:Views from the Golden Gate Bridge deck, Golden Gate Bridge category for the view from the item Category:Views from the Golden Gate Bridge towers	yes
Princess Mary of York (1897-1965), later Princess Royal and Countess of Harewood pendant of Prince Edward of York (1894-1972), later King Edward VIII, Princess Mary of York (1897-1965), later Princess Royal and Countess of Harewood pendant of Prince Albert of York (1895-1952), later King George VI	yes
Vyacheslav Popov military branch navy, Vyacheslav Popov military branch Russian Navy	yes
Kotscherigin TSch-3 wing configuration monoplane, Kotscherigin TSch-3 wing configuration low wing	yes
Vulcan lifestyle vegetarianism, Vulcan lifestyle insularity	no
Vincent Cassel filmography La Haine, Vincent Cassel filmography Ocean's Twelve	yes
Westfields Infant School Ofsted inspection rating Requires Improvement, Westfields Infant School Ofsted inspection rating Good	yes
Finland language used French, Finland language used Ossetian	no
Doryclus Hederich encyclopedia article Doryclvs, Doryclus Hederich encyclopedia article Doricops	no
RTS Planeta online access status registration required, RTS Planeta online access status paywall	yes
amikacin subject has role antibiotic, amikacin subject has role bactericide	no
Royal Tropical Institute building category for the interior of the item Category:Interior of the Wereldmuseum Amsterdam, Royal Tropical Institute building category for the interior of the item Category:Interior of Tropeninstituut building	yes
strawberry natural product of taxon strawberry, strawberry natural product of taxon Fragaria	no
song type is metaclass for song, song type is metaclass for musical work/composition	yes
O-52 Owl wing configuration monoplane, O-52 Owl wing configuration shoulder wing	yes
Israel official symbol Eurasian Hoopoe, Israel official symbol Canaan Dog	no
Bloch MB.220 wing configuration cantilever, Bloch MB.220 wing configuration low wing	yes
Cicindelina this zoological name is coordinate with Cicindelinae, Cicindelina this zoological name is coordinate with Cicindelini	no
HTC One M9+ category for pictures taken with this camera Category:Taken with HTC One M9e, HTC One M9+ category for pictures taken with this camera Category:Taken with HTC One M9+	yes
Hyphanet copyright license GNU General Public License, Hyphanet copyright license MIT License	no
Zootopia ICAA rating general audiences, Zootopia ICAA rating Particularly suitable for kids	no
humanities is the study of history, humanities is the study of literature	no
WrestleMania organizational divisions WWE SmackDown, WrestleMania organizational divisions WWE Raw	no
Switzerland language used French, Switzerland language used Italian	no
aspirin medical condition treated myocardial infarction, aspirin medical condition treated pain	no
Mother 3 CERO rating A (All ages), Mother 3 CERO rating All Ages	yes
vanillin produced by Oryza sativa, vanillin produced by Pseudomonas chlororaphis	no
Nobel Peace Prize winner Barack Obama, Nobel Peace Prize winner Fridtjof Nansen	yes
Erzya Language Day category for recipients of this award Vladimir Romashkin, Erzya Language Day category for recipients of this award Chislav Zhuravlyov	yes
Jungfernsee outflows Havel, Jungfernsee outflows Sacrow–Paretz Canal	yes
MediaWiki depends on software PHP, MediaWiki depends on software ImageMagick	no
Korabl-Sputnik 2 space launch vehicle Vostok-L, Korabl-Sputnik 2 space launch vehicle Vostok	yes
Japan significant event World War II, Japan significant event Great Hanshin Earthquake	no
Xylosma benthamii has basionym Flacourtia benthamii, Xylosma benthamii has basionym Myroxylon benthamii	yes
Sylheti uses Wikivoyage, Sylheti uses Wikispore	no
HTC One M9+ category for pictures taken with this camera Category:Taken with HTC One M9+, HTC One M9+ category for pictures taken with this camera Category:Taken with HTC One M9e	yes
Yazidism diaspora Georgia, Yazidism diaspora Australia	no
Wildspitze parent peak Mont Blanc, Wildspitze parent peak Ortler	no
Cristinia gallica has basionym Radulum eichleri, Cristinia gallica has basionym Radulum gallicum	yes
Dinorwig Power Station reservoir created Marchlyn Mawr, Dinorwig Power Station reservoir created Llyn Peris	yes
Sonic Adventure 2 USK rating USK 0, Sonic Adventure 2 USK rating USK 6	yes
Sancho patronym or matronym for this name Sainz, Sancho patronym or matronym for this name Saz	no
Amaurose film editor Juliane Lorenz, Amaurose film editor Andrea Wenzler	no
Asia shipping port Genoa, Asia shipping port Trieste	no
Amphibia main food source insect, Amphibia main food source Isopoda	no
Noalyss depends on software PHP, Noalyss depends on software PostgreSQL	no
Mickey Mantle handedness ambidexterity, Mickey Mantle handedness switch-hitter	yes
(31385) 1998 XF96 site of astronomical discovery Mérida, (31385) 1998 XF96 site of astronomical discovery Llano del Hato National Astronomical Observatory	yes
XCENTRiC character role minimal house, XCENTRiC character role tech house	no
Buddlejaceae has fruit type capsule, Buddlejaceae has fruit type berry	no
Zhongdian-Yak ‎breed belongs to taxon Bos grunniens, Zhongdian-Yak ‎breed belongs to taxon Bos mutus grunniensis	yes
employer male form of label employeur, employer male form of label empleador	no
Apple M1 Pro microarchitecture Apple Firestorm, Apple M1 Pro microarchitecture Apple Icestorm	yes
leptospirosis medical examination electrocardiography, leptospirosis medical examination echocardiography	no
Chennai subreddit Chennai, Chennai subreddit chennaii	no
Great Diamond constellation Boötes, Great Diamond constellation Coma Berenices	yes
Czechoslovakia central bank National Bank of Czechoslovakia, Czechoslovakia central bank State Bank of Czechoslovakia	yes
1 mathematical inverse −1, 1 mathematical inverse 1	yes
Latin has grammatical case vocative case, Latin has grammatical case dative case	no
Hastein subject named as Haftingus, Hastein subject named as Aflengus de Nantouillet	no
niningerite type locality (geology) Abee meteorite, niningerite type locality (geology) Indarch meteorite	no
Hastein subject named as Aflengo Nantolio, Hastein subject named as Aflengus de Nantouillet	no
Empress Xiaogongren Eight Banner register Manchu Plain Yellow Banner, Empress Xiaogongren Eight Banner register Bondservant Division of Plain Yellow Banner	yes
Béla Bartók list of works Szőllősy index, Béla Bartók list of works list of compositions by Béla Bartók	yes
Fitil narrator Vladimir Yeryomin, Fitil narrator Alexander Mitta	no
Trigger make-up artist Anja Dahl, Trigger make-up artist Irene Dyrdal Skar	no
Oder mouth of the watercourse Baltic Sea, Oder mouth of the watercourse Szczecin Lagoon	no
2021 Puebla ePrix pole position Pascal Wehrlein, 2021 Puebla ePrix pole position Oliver Rowland	yes
⺄ radical Kangxi radical 5 (⼄), ⺄ radical CJK radical second three (⺄)	yes
Novoalexandrovsk flag flag, Novoalexandrovsk flag flag of Novoalexandrovsk	no
Waluigi wears shoe, Waluigi wears cap	no
Casio Exilim EX-P600 category for pictures taken with this camera Category:Taken with Casio Exilim Pro EX-P600, Casio Exilim EX-P600 category for pictures taken with this camera Category:Taken with Casio Exilim EX-P600	yes
The Sun Also Rises copyright status public domain, The Sun Also Rises copyright status copyrighted	yes
iron vanadate crystal system triclinic crystal system, iron vanadate crystal system orthorhombic crystal system	yes
feminism opposite of antifeminism, feminism opposite of sexism	no
1957 Modena Grand Prix fastest lap Jean Behra, 1957 Modena Grand Prix fastest lap Luigi Musso	yes
A2 autostrada state of use proposed building or structure, A2 autostrada state of use in use	yes
Cinderella nickname Cinderella, Cinderella nickname Aschenputtel	no
Mongolian People's Republic anthem National anthem of Mongolia, Mongolian People's Republic anthem Mongol Internationale	yes
Prince Albert of York (1895-1952), later King George VI pendant of Prince Edward of York (1894-1972), later King Edward VIII, Prince Albert of York (1895-1952), later King George VI pendant of Princess Mary of York (1897-1965), later Princess Royal and Countess of Harewood	yes
closest string computational complexity NP-hardness, closest string computational complexity NP-complete	yes
A Bug's Life USK rating USK 0, A Bug's Life USK rating USK 6	yes
Obomma has characteristic color, Obomma has characteristic durability	no
Maria Salome und Maria Cleophae is recto of Die Verkündigung an Maria, Maria Salome und Maria Cleophae is recto of Circumcision of Jesus	yes
rubidium dichromate crystal system triclinic crystal system, rubidium dichromate crystal system monoclinic crystal system	yes
Leprechaun MAME ROM name potogold, Leprechaun MAME ROM name leprechn	no
European Union legislative body Council of the European Union, European Union legislative body European Parliament	yes
shellfish natural product of taxon Crustacea, shellfish natural product of taxon Mollusca	no
Kerkenes director of archaeological fieldwork Erich Schmidt, Kerkenes director of archaeological fieldwork Scott Branting	no
French indigenous to Luxembourg, French indigenous to canton of Vaud	no
ALGOL designed by Alan Perlis, ALGOL designed by Adriaan van Wijngaarden	no
Robin incarnation of Carrie Kelley, Robin incarnation of Damian Wayne	no
Bitrise reply to CircleCI, Bitrise reply to Travis CI	no
Sastavci enclave within Priboj Municipality, Sastavci enclave within Zlatibor District	no
Emperor Suzong of Tang family Tang dynasty, Emperor Suzong of Tang family House of Li	yes
Unity operating system Android, Unity operating system Linux	no
leptospirosis medical examination electrocardiography, leptospirosis medical examination lumbar puncture	no
Deniz literal translation Sea, Deniz literal translation Mar	no
Robin incarnation of Damian Wayne, Robin incarnation of Carrie Kelley	no
argument image of function Upper open interval between 0 and 2π, argument image of function set of real numbers	yes
metronidazole medical condition treated pneumonia, metronidazole medical condition treated postoperative complications	no
Amphibia main food source Arachnida, Amphibia main food source Isopoda	no
Edgar Julius Jung manner of death capital punishment, Edgar Julius Jung manner of death homicide	yes
Involuntary CNC film rating (France) no age restriction, Involuntary CNC film rating (France) warning	no
Johor lowest point Straits of Johor, Johor lowest point South China Sea	yes
Base −1 ± i radix −1+i, Base −1 ± i radix −1−i	yes
Ubuntu derivative work Linux Mint, Ubuntu derivative work KDE neon	no
Caroline Peters list of works Beautiful Women, Caroline Peters list of works Arnie's World	yes
Australia aircraft registration prefix VJ, Australia aircraft registration prefix VL	no
ARC file extension ark, ARC file extension sue	no
Quechua category for films in this language Category:Quechua-language films, Quechua category for films in this language Category:Southern Quechua-language films	yes
human properties for this type image, human properties for this type family name	no
Northern Local Supervoid constellation Boötes, Northern Local Supervoid constellation Virgo	yes
Deniz literal translation Meer, Deniz literal translation Mar	no
United Kingdom top-level Internet domain .gb, United Kingdom top-level Internet domain .uk	yes
CALLISTO designed by CNES, CALLISTO designed by German Aerospace Center	no
Malta located in/on physical feature Europe, Malta located in/on physical feature Southern Europe	no
Pfarrkirche patron saint Paul the Apostle, Pfarrkirche patron saint Saint Peter	no
Sri Lanka Bush Warbler original combination Brachypteryx palliseri, Sri Lanka Bush Warbler original combination Sri Lanka bush-warbler	yes
Vincent Cassel filmography La Haine, Vincent Cassel filmography The Crimson Rivers	yes
Boeing child organization/unit Boeing Commercial Airplanes, Boeing child organization/unit Boeing Spain	no
tenoxicam significant drug interaction aspirin, tenoxicam significant drug interaction paroxetine	no
VVVVVV operating system Android, VVVVVV operating system iOS	no
Italian has grammatical gender feminine, Italian has grammatical gender masculine	no
Trophies dataset distribution digital distribution, Trophies dataset distribution vinyl record	no
Finland language used French, Finland language used Kurdish	no
Northern Local Supervoid constellation Boötes, Northern Local Supervoid constellation Serpens	yes
Burlakov case court Panama, Burlakov case court Russia	yes
Romanian Academy substitute/deputy/replacement of office/officeholder Alexandru Surdu, Romanian Academy substitute/deputy/replacement of office/officeholder Bogdan Simionescu	yes
RRC 546/2 central bank/issuer Mark Antony, RRC 546/2 central bank/issuer Lucius Pinarius	yes
The Outer Limits list of episodes list of The Outer Limits episodes, The Outer Limits list of episodes list of The Outer Limits (1995 TV series) episodes	yes
Latin has grammatical case vocative case, Latin has grammatical case genitive case	no
Greece right to vote voting age, Greece right to vote universal suffrage	no
van Strydonck de Burkel infix van, van Strydonck de Burkel infix de	yes
official website corresponding template Template:Official URL, official website corresponding template Template:Official website	yes
Paris owner of Eiffel Tower, Paris owner of The Sleepers	yes
Alucard superhuman feature or ability telekinesis, Alucard superhuman feature or ability omnipresence	no
Hannah Montana list of characters list of Hannah Montana characters, Hannah Montana list of characters list of Hannah Montana main characters	yes
Bionicle Heroes ESRB rating Everyone, Bionicle Heroes ESRB rating Everyone 10+	yes
Prunus rivularis NatureServe conservation status secure, Prunus rivularis NatureServe conservation status apparently secure	yes
arXiv board member Robert Seiringer, arXiv board member David Robert Nelson	no
Chrysomeloidea this zoological name is coordinate with Chrysomelinae, Chrysomeloidea this zoological name is coordinate with Chrysomelini	no
Countess Ludwika Tyzenhauz family House of Tiesenhausen, Countess Ludwika Tyzenhauz family House of Pac	yes
Lrp dual to gadW, Lrp dual to aspA	no
Grandpaw Mort Barker animal breed beagle, Grandpaw Mort Barker animal breed basset hound	yes
Earth child astronomical body Hubble Space Telescope, Earth child astronomical body Lemu Nge	no
Pakistan highest judicial authority Supreme  Appellate Court Gilgit-Baltistan, Pakistan highest judicial authority Supreme Court of Azad Jammu & Kashmir	yes
Söderkulla Church diocese Diocese of Helsinki, Söderkulla Church diocese Diocese of Borgå	yes
Paris owner of Eiffel Tower, Paris owner of Hôtel de Chalon-Luxembourg	yes
Burlakov case court Panama, Burlakov case court United Kingdom	yes
proton interaction electromagnetic interaction, proton interaction gravity	no
Dendera Commons gallery Denderah, Dendera Commons gallery Dendera	no
Valukarama statement is subject of Walukarama Maha Viharaya, Valukarama statement is subject of Valukaramaya	no
Delta manufacturer Boeing, Delta manufacturer Douglas	no
St. Margaret Senior High School motto success, St. Margaret Senior High School motto prayer	yes
benzylpenicillin subject has role antibiotic, benzylpenicillin subject has role bactericide	no
Nobel Peace Prize winner Barack Obama, Nobel Peace Prize winner Henry Kissinger	yes
Trine ESRB rating Everyone, Trine ESRB rating Everyone 10+	yes
Sur official name Yosemite, Sur official name Sur	no
1 mathematical inverse 1, 1 mathematical inverse −1	yes
arXiv board member Robert Seiringer, arXiv board member Dong Lai	no
Abdal relative to Abrar, Abdal relative to Ghawth	no
Sima power station reservoir created Sysenvatnet, Sima power station reservoir created Langvatn	yes
Alien BBFC rating 15 certificate, Alien BBFC rating 18 certificate	yes
Museum für Hamburgische Geschichte content partnership category Category:Media contributed by the Hamburg Museum, Museum für Hamburgische Geschichte content partnership category Category:Cooperation images - Museum für Hamburgische Geschichte	yes
Interflug Flight 102 start point Berlin, Interflug Flight 102 start point Berlin Schönefeld Airport	yes
varenicline active ingredient in Champix, varenicline active ingredient in Chantix	no
Falles intangible cultural heritage status Festival of International Tourist Interest of Spain, Falles intangible cultural heritage status Representative List of the Intangible Cultural Heritage of Humanity	no
The House of the Dead ELSPA rating 3+, The House of the Dead ELSPA rating 15+	yes
pyrrhotite crystal system monoclinic crystal system, pyrrhotite crystal system hexagonal crystal system	no
clarithromycin subject has role antibiotic, clarithromycin subject has role developmental toxicant	no
Ixodida natural reservoir of Oz virus, Ixodida natural reservoir of Yezo orthonairovirus	no
Canada diplomatic relation Hungary, Canada diplomatic relation Ukraine	no
First premiership of Mahathir Mohamad has cabinet Fourth Mahathir cabinet, First premiership of Mahathir Mohamad has cabinet First Mahathir cabinet	yes
Chrysomelini this zoological name is coordinate with Chrysomelidae, Chrysomelini this zoological name is coordinate with Chrysomelina	no
shimazakiite space group space group P2₁/m, shimazakiite space group space group P2/m	yes
Crossover takes place in fictional universe Mirror Universe, Crossover takes place in fictional universe Star Trek universe	yes
Lake Biel outflows Aare, Lake Biel outflows Nidau-Büren Canal	yes
bass guitar lowest note D, bass guitar lowest note C♯	yes
Category:Philosophy-related glossaries list related to category glossary of philosophy, Category:Philosophy-related glossaries list related to category glossary of Stoicism terms	yes
Pakistan highest judicial authority Supreme  Appellate Court Gilgit-Baltistan, Pakistan highest judicial authority Supreme Court of Pakistan	yes
St. John the Baptist Cathedral, Lublin category for the exterior of the item Category:Exterior of the Lublin Cathedral at night, St. John the Baptist Cathedral, Lublin category for the exterior of the item Category:Exterior of the Lublin Cathedral	yes
Star Fox 64 ESRB rating Everyone, Star Fox 64 ESRB rating Kids to Adults	yes
archdeacon next lower rank hierodeacon, archdeacon next lower rank deacon	no
vanillin produced by Bacillus subtilis, vanillin produced by Aspergillus niger	no
banku together with stew, banku together with Shito	no
square root image of function complex plane, square root image of function Riemann sphere	yes
Nobel Peace Prize winner Barack Obama, Nobel Peace Prize winner Alfred Hermann Fried	yes
Henri-Marie Dubreil de Pontbriand diocese Montreal, Henri-Marie Dubreil de Pontbriand diocese Saint-Malo	yes
Camino copyright license GNU General Public License, Camino copyright license Mozilla Public License	no
Spirit: Stallion of the Cimarron Australian Classification G, Spirit: Stallion of the Cimarron Australian Classification PG	yes
Android package management system Amazon Appstore, Android package management system Google Play	no
Heiban UNESCO language status 2 vulnerable, Heiban UNESCO language status 4 severely endangered	yes
Neftekumsk flag flag, Neftekumsk flag flag of Neftekumsk	no
Zelenokumsk flag flag, Zelenokumsk flag flag of Zelenokumsk	yes
sumo regulated by Japan Sumo Federation, sumo regulated by Japan Sumo Association	no
Tendermint computes solution to Byzantine fault, Tendermint computes solution to consensus	no
banku together with stew, banku together with Capsicum	no
budget type of unit for this property virtual currency, budget type of unit for this property fictional currency	no
Aliens BBFC rating 15 certificate, Aliens BBFC rating 18 certificate	yes
Tlapanec UNESCO language status 2 vulnerable, Tlapanec UNESCO language status 4 severely endangered	yes
cosmopolitanism opposite of nationalism, cosmopolitanism opposite of patriotism	yes
Oyoko (clan) totem falcon, Oyoko (clan) totem hawk	yes
vanillin produced by Bacillus subtilis, vanillin produced by clove	no
auriculo condylar syndrome mode of inheritance autosomal dominant, auriculo condylar syndrome mode of inheritance autosomal recessive	yes
Troy subreddit troy, Troy subreddit troyny	no
Septuagint edition or translation of Bible, Septuagint edition or translation of Old Testament	no
National Museum of World Cultures content partnership category Category:Images from the Wereldmuseum Amsterdam, National Museum of World Cultures content partnership category Category:Files from the Nationaal Museum van Wereldculturen	yes
Imperial Noble Consort Huixian Eight Banner register Bondservant Division of Bordered Yellow Banner, Imperial Noble Consort Huixian Eight Banner register Manchu Bordered Yellow Banner	yes
Erzya Language Day category for recipients of this award Chislav Zhuravlyov, Erzya Language Day category for recipients of this award Aleksandr Sharonov	yes
Alexander CNC film rating (France) no age restriction, Alexander CNC film rating (France) warning	no
Short-tailed bandicoot rat Wildlife Protection Act 1972 (India) schedule Schedule V of Wildlife Protection Act, 1972, Short-tailed bandicoot rat Wildlife Protection Act 1972 (India) schedule Schedule IV of Wildlife Protection Act, 1972	yes
First premiership of Mahathir Mohamad has cabinet Fourth Mahathir cabinet, First premiership of Mahathir Mohamad has cabinet Fifth Mahathir cabinet	yes
French has tense pluperfect, French has tense past imperfect	no
Nickelback record label Roadrunner Records, Nickelback record label Atlantic Records	no
rafting associated hazard death, rafting associated hazard hypothermia	no
WrestleMania organizational divisions WWE SmackDown, WrestleMania organizational divisions WWE NXT	no
Troy director of archaeological fieldwork Manfred Korfmann, Troy director of archaeological fieldwork Carl Blegen	no
Mikhaylovsk flag flag, Mikhaylovsk flag flag of Mikhaylovsk	yes
ampicillin subject has role antibiotic, ampicillin subject has role bactericide	no
Sylheti uses Wikibooks, Sylheti uses Wikidata	no
Wikidata dataset distribution Wikidata JSON dumps, Wikidata dataset distribution Wikidata RDF Dump Format	no
Yazidism diaspora Georgia, Yazidism diaspora Russia	no
Betacoronavirus 1 replaced synonym (for nom. nov.) Human coronavirus OC43, Betacoronavirus 1 replaced synonym (for nom. nov.) Equine coronavirus	yes
Johor lowest point South China Sea, Johor lowest point Strait of Malacca	no
Wario wears shoe, Wario wears glove	no
motorsport topic's main Wikimedia portal Portal:Motorcycle racing, motorsport topic's main Wikimedia portal Portal:Motorsport	yes
plague disease transmission process contact transmission, plague disease transmission process airborne transmission	no
Wikibase depends on software PHP, Wikibase depends on software JavaScript	no
Erzya Language Day category for recipients of this award Chislav Zhuravlyov, Erzya Language Day category for recipients of this award Vladimir Romashkin	yes
human properties for this type image, human properties for this type height	no
leptospirosis anatomical location lung, leptospirosis anatomical location kidney	no
Nepal religion or worldview Islam, Nepal religion or worldview Kirat Mundhum	no
Garota fabrication method graphite, Garota fabrication method wash technique	no
amen practiced by Jewish people, amen practiced by angel in Islam	no
Japan significant event World War II, Japan significant event Treaty of San Francisco	no
Portal:France Wikimedia portal's main topic France, Portal:France Wikimedia portal's main topic 5th Army	yes
Garrison game artist Ulrich Weltner, Garrison game artist Roland Petermann	no
Valladolid coextensive with Valladolid, Valladolid coextensive with Valladolid	no
Sima power station reservoir created Sysenvatnet, Sima power station reservoir created Rembesdalsvatn	yes
WarioWare, Inc.: Mega Party Games! USK rating USK 0, WarioWare, Inc.: Mega Party Games! USK rating USK 6	yes
Esperantujo continent South America, Esperantujo continent Antarctica	no
We Are the Others RCQ classification G, We Are the Others RCQ classification 13+	yes
Vim SourceForge project vimdoc, Vim SourceForge project vim	no
Sonic Generations PEGI rating PEGI 3, Sonic Generations PEGI rating PEGI 7	yes
Kascha eye color blue, Kascha eye color hazel	no
2005–06 La Liga rules for classification more points, 2005–06 La Liga rules for classification more head-to-head goals scored	yes
Erzya Language Day category for recipients of this award Vladimir Romashkin, Erzya Language Day category for recipients of this award Aleksandr Sharonov	yes
A Quiet Life EIRIN film rating G, A Quiet Life EIRIN film rating PG12	yes
Deniz literal translation Sea, Deniz literal translation Zee	no
lion produced sound roar, lion produced sound lion roar	no
Throne of Blood EIRIN film rating G, Throne of Blood EIRIN film rating PG12	yes
Paris owner of Eiffel Tower, Paris owner of Accor Arena	yes
Fitil narrator Vladimir Yeryomin, Fitil narrator Sergey Kondratyev	no
German has grammatical mood indicative, German has grammatical mood subjunctive	no
Pégaso web interface software Intel oneAPI Math Kernel Library, Pégaso web interface software OpenMP	yes
Tasattur mandates veil, Tasattur mandates trousers	no
auriculo condylar syndrome mode of inheritance autosomal recessive, auriculo condylar syndrome mode of inheritance autosomal dominant	yes
soybean this taxon is source of soybean oil, soybean this taxon is source of soy bean	no
Japan has seal, badge, or sigil Imperial Seal of Japan, Japan has seal, badge, or sigil national seal	yes
tenoxicam significant drug interaction aspirin, tenoxicam significant drug interaction nabumetone	no
Cristinia gallica has basionym Radulum gallicum, Cristinia gallica has basionym Radulum eichleri	yes
Born to Raise Hell EIRIN film rating G, Born to Raise Hell EIRIN film rating PG12	yes
Czechoslovakia central bank State Bank of Czechoslovakia, Czechoslovakia central bank National Bank of Czechoslovakia	yes
The House of the Dead ELSPA rating 11+, The House of the Dead ELSPA rating 15+	yes
Iowa lowest point Mississippi River, Iowa lowest point Des Moines River	yes
Euskaldunization and Literacy Coordinator legal form cooperative, Euskaldunization and Literacy Coordinator legal form association	yes
Frank animal breed dachshund, Frank animal breed beagle	yes
Actinidiaceae has fruit type berry, Actinidiaceae has fruit type capsule	no
Loire tributary Divatte, Loire tributary Somme	no
Hungary member of European Union, Hungary member of International Energy Agency	no
Pivot depends on software PHP, Pivot depends on software MediaWiki	no
Latin has grammatical case ablative case, Latin has grammatical case vocative case	no
libcurl manifestation of HTTP, libcurl manifestation of SSH File Transfer Protocol	no
tow by-product of heckling, tow by-product of scutching	no
2005–06 La Liga rules for classification more points, 2005–06 La Liga rules for classification bigger head-to-head goal difference	yes
Deadpool 2 Hong Kong film rating Category IIB, Deadpool 2 Hong Kong film rating Category III	yes
tenoxicam significant drug interaction aspirin, tenoxicam significant drug interaction piroxicam	no
Five Nights at Freddy's BBFC rating 15 certificate, Five Nights at Freddy's BBFC rating 15A certificate	yes
Indiana lowest point Ohio River, Indiana lowest point Wabash River	yes
Beyond Oasis USK rating USK 0, Beyond Oasis USK rating USK 12	yes
John the Baptist and Joachim - Inzigkofen Altar is recto of Der Tempelgang Mariae, John the Baptist and Joachim - Inzigkofen Altar is recto of The Visitation	yes
Russia designated as terrorist by Ukraine, Russia designated as terrorist by Slovakia	no
Abraham worshipped by Islam, Abraham worshipped by Christianity	no
Twinrix vaccine for hepatitis A, Twinrix vaccine for hepatitis B	no
Chiquitita has melody Three Wise Guys, Chiquitita has melody Chiquitita Angelina	no
knapsack problem computational complexity NP-hardness, knapsack problem computational complexity NP-complete	yes
Michael Clarke handedness left-handedness, Michael Clarke handedness right-handedness	yes
2021 London ePrix pole position Stoffel Vandoorne, 2021 London ePrix pole position Alex Lynn	yes
sine mathematical inverse arcsine, sine mathematical inverse cosecant	yes
square root codomain set of real numbers, square root codomain complex plane	yes
shimazakiite space group space group P2₁/m, shimazakiite space group space group Pm	yes
Super Mario 64 DS PEGI rating PEGI 3, Super Mario 64 DS PEGI rating PEGI 12	yes
ActRaiser review score by Nintendo Power, ActRaiser review score by Electronic Gaming Monthly	no
Agworok people economy of topic yam, Agworok people economy of topic rice	yes
Hymen mother Urania, Hymen mother Aphrodite	no
Sollac legal form cooperative, Sollac legal form S.A.	yes
Cullercoats fare zone Metro fare zone C, Cullercoats fare zone Transfare Grey Zone	no
ASPIC statistical unit used commune of France, ASPIC statistical unit used department of France	no
Saraswati worshipped by Hinduism, Saraswati worshipped by Buddhism	no
Egypt top-level Internet domain .مصر, Egypt top-level Internet domain .eg	yes
Royal Tropical Institute building category for the interior of the item Category:Interior of Tropeninstituut building, Royal Tropical Institute building category for the interior of the item Category:Interior of the Wereldmuseum Amsterdam	yes
Yazidism diaspora Georgia, Yazidism diaspora United States	no
Alaska foundational text An Act to provide for the admission of the State of Alaska into the Union, Alaska foundational text Constitution of Alaska	no
2021 New York City ePrix pole position Sam Bird, 2021 New York City ePrix pole position Nick Cassidy	yes
Betacoronavirus 1 replaced synonym (for nom. nov.) Human coronavirus OC43, Betacoronavirus 1 replaced synonym (for nom. nov.) Human enteric coronavirus	yes
Saifai electoral district Mainpuri Lok Sabha constituency, Saifai electoral district Jaswantnagar Vidhan Sabha constituency	no
Wikibase depends on software MediaWiki, Wikibase depends on software PHP	no
Graveland port of registry Amsterdam, Graveland port of registry Piraeus	no
Order of the Wendish Crown donated by Frederick Francis II, Order of the Wendish Crown donated by Frederick William, Grand Duke of Mecklenburg-Strelitz	yes
benzylpenicillin subject has role antibiotic, benzylpenicillin subject has role penicillin	no
Church of the Holy Trinity category for the interior of the item Category:Interior of Dreifaltigkeitskirche (Görlitz), Church of the Holy Trinity category for the interior of the item Category:Interior of the Barbara Chapel	yes
RRC 517/6 central bank/issuer Mark Antony, RRC 517/6 central bank/issuer Marcus Cocceius Nerva	yes
acute angle opposite of right angle, acute angle opposite of turn	yes
racism contributing factor of persecution of Muslims in Burma, racism contributing factor of colonisation of Africa	no
Joseph child Jesus, Joseph child James the Just	no
Category:Olympic medalists in fencing list related to category list of male Olympic medalists in fencing, Category:Olympic medalists in fencing list related to category list of female Olympic medalists in fencing	yes
Canada diplomatic relation Hungary, Canada diplomatic relation Finland	no
Paris owner of Eiffel Tower, Paris owner of Parc des Princes	yes
infinity opposite of zero, infinity opposite of infinitesimal	yes
rafting associated hazard giardiasis, rafting associated hazard hemlock poisoning	no
Category:Cultural heritage monuments in Quebec City list related to category list of historic places in Quebec City, Category:Cultural heritage monuments in Quebec City list related to category liste du patrimoine immobilier de Québec	yes
Taiwan geography of topic geography of China, Taiwan geography of topic geography of Taiwan	yes
Vincent Cassel filmography Ocean's Twelve, Vincent Cassel filmography La Haine	yes
Telestar conferred by ZDF, Telestar conferred by Westdeutscher Rundfunk	no
Helge given name version for other gender Helga, Helge given name version for other gender Helle	no
country related property country of citizenship, country related property country for sport	no
Dachstein category for the view from the item Category:Views from Dachstein Massif, Dachstein category for the view from the item Category:Views from Hunerkogel	yes
ITER sponsor United States, ITER sponsor India	no
Charmed list of characters list of Charmed villains, Charmed list of characters list of guest characters in Charmed	yes
ActRaiser review score by IGN, ActRaiser review score by Electronic Gaming Monthly	no
Xenocrates student of Plato, Xenocrates student of Aeschines of Sphettus	no
2021 Puebla ePrix pole position Oliver Rowland, 2021 Puebla ePrix pole position Pascal Wehrlein	yes
Polish has conjugation class fourth conjugation, Polish has conjugation class third conjugation	no
Aralia castanopsiscola has basionym Pentapanax castanopsiscolus, Aralia castanopsiscola has basionym Pentapanax castanopsicola	yes
Kryptopithecus endemic to California, Kryptopithecus endemic to United States	no
racism contributing factor of colonisation of Africa, racism contributing factor of European colonization of the Americas	no
racism contributing factor of colonisation of Africa, racism contributing factor of The Holocaust	no
RELN decreased expression in bipolar disorder, RELN decreased expression in schizophrenia	no
Gansu party chief representative Li Ziqi, Gansu party chief representative Wang Sanyun	no
Heroes broadcast by NBC, Heroes broadcast by RTL TVI	no
Czech has grammatical gender feminine, Czech has grammatical gender masculine	no
Hastein subject named as Aflingus de Nantolio, Hastein subject named as Aflengus de Nantouillet	no
Fitil narrator Vladimir Yeryomin, Fitil narrator Vsevolod Larionov	no
Aozora Bunko copyright status public domain, Aozora Bunko copyright status copyrighted	yes
Pietà EIRIN film rating G, Pietà EIRIN film rating R15+	yes
Goh has pet Bunnelby, Goh has pet Pikachu	no
Durga worshipped by Hinduism, Durga worshipped by Tantra	no
Stargate ESRB rating Everyone, Stargate ESRB rating Kids to Adults	no
Switzerland flag flag of Switzerland, Switzerland flag civil ensign of Switzerland	yes
Prince Edward of York (1894-1972), later King Edward VIII pendant of Princess Mary of York (1897-1965), later Princess Royal and Countess of Harewood, Prince Edward of York (1894-1972), later King Edward VIII pendant of Prince Albert of York (1895-1952), later King George VI	yes
Białystok Cathedral category for the exterior of the item Category:Exterior of the Białystok Cathedral at night, Białystok Cathedral category for the exterior of the item Category:Exterior of the Archcathedral Basilica in Białystok	yes
Andhaka stated in Linga Purana, Andhaka stated in Kurma Purana	no
Oyoko (clan) totem hawk, Oyoko (clan) totem falcon	yes
Francia capital Paris, Francia capital Aachen	yes
Google owner of Waymo, Google owner of Google Chrome Experiments	no
Oxyd game artist Timo Oland, Oxyd game artist Lionel Barbier	no
Loire-Nieuport LN.401 wing configuration monoplane, Loire-Nieuport LN.401 wing configuration Inverted gull wing	yes
integralism in opposition to liberalism, integralism in opposition to pluralism	no
Nokia stock exchange New York Stock Exchange, Nokia stock exchange Nasdaq Helsinki Ltd	no
pascal measured physical quantity mechanical stress, pascal measured physical quantity shear modulus	no
Alpspitze category for the view from the item Category:Views from Alpspitze, Alpspitze category for the view from the item Category:Views from Meilerhütte	yes
human properties for this type image, human properties for this type ISNI	no
Sieglangersteg crosses Inn, Sieglangersteg crosses Inn Valley Autobahn	no
Zootopia theme music Everybody Hurts, Zootopia theme music Try Everything	no
Sahara ecoregion (WWF) Sahara Desert, Sahara ecoregion (WWF) West Saharan montane xeric woodlands	no
openSUSE GUI toolkit or framework LXDE, openSUSE GUI toolkit or framework MATE	no
Mount Rainier category for the view of the item Category:Views of Mount Rainier from Sumner, Washington, Mount Rainier category for the view of the item Category:Views of Mount Rainier	yes
Cassa di Risparmio di Voghera legal form investment, Cassa di Risparmio di Voghera legal form joint-stock company	yes
Maria MTRCB rating R-16, Maria MTRCB rating R-18	yes
Quebec list of monuments list of National Historic Sites of Canada in Quebec, Quebec list of monuments list of historic places in Quebec	no
Merakpa ‎breed belongs to taxon Bos mutus grunniensis, Merakpa ‎breed belongs to taxon Bos grunniens	yes
Tshangla UNESCO language status 2 vulnerable, Tshangla UNESCO language status 3 definitely endangered	yes
Kasuliyili Senior High School category for alumni of educational institution teacher, Kasuliyili Senior High School category for alumni of educational institution manager	yes
Czech has grammatical gender feminine, Czech has grammatical gender neuter	no
Canada diplomatic relation Hungary, Canada diplomatic relation Singapore	no
井 grade of kanji jōyō kanji, 井 grade of kanji grade 4 kyōiku kanji	yes
Russian Soviet Federative Socialist Republic anthem State Anthem of the Soviet Union, Russian Soviet Federative Socialist Republic anthem The Internationale	yes
curl implementation of File Transfer Protocol, curl implementation of Gopher	no
ActRaiser review score by Electronic Gaming Monthly, ActRaiser review score by Nintendo Power	no
Yogi Bear Australian Classification G, Yogi Bear Australian Classification PG	yes
You are beautiful, my forest anthem Koprivshtitsa, You are beautiful, my forest anthem National assembly of Bulgarian folk art	yes
Moscow capital of Russia, Moscow capital of Central Federal District	no
National Library of Israel content partnership category Category:GLAM National Library of Israel, National Library of Israel content partnership category Category:Images donated as part of the collaboration project between National Library of Israel and Wikimedia Israel	yes
Metropolis copyright status public domain, Metropolis copyright status copyrighted	yes
Rococo manner of color, Rococo manner of motion	no
The Crow MTRCB rating R-18, The Crow MTRCB rating R-16	yes
Château de Chenonceau category for the interior of the item Category:Interior of Château de Chenonceau, Château de Chenonceau category for the interior of the item Category:Interior of Château de Chenonceau before 1900	yes
New Caledonia flag flag of France, New Caledonia flag flags of New Caledonia	yes
Harvest place of publication Canada, Harvest place of publication United States	no
Taiwan geography of topic geography of Taiwan, Taiwan geography of topic geography of China	yes
Adi UNESCO language status 2 vulnerable, Adi UNESCO language status 3 definitely endangered	yes
Michael Jackson: The Experience PEGI rating PEGI 3, Michael Jackson: The Experience PEGI rating PEGI 12	yes
Taiwan significant event World War II, Taiwan significant event Period of mobilization for the suppression of Communist rebellion	no
Dan activator of ttdR, Dan activator of ttdA	no
Vyborg Köppen climate classification oceanic climate, Vyborg Köppen climate classification continental climate	no
Female Figure Holding a Bridle [reverse] is verso of Elisabetta Gonzaga, died 1526, Duchess of Urbino, Wife of Guidobaldo I 1489 [obverse], Female Figure Holding a Bridle [reverse] is verso of Elisabetta Gonzaga, died 1528, Duchess of Urbino, Wife of Guidobaldo I 1489 [obverse]	yes
CSI: NY list of characters minor characters in CSI: NY, CSI: NY list of characters list of CSI: NY characters	yes
Silent Hill: Revelation Hong Kong film rating Category IIB, Silent Hill: Revelation Hong Kong film rating Category III	yes
Hustler Hollywood typically sells sex toy, Hustler Hollywood typically sells lingerie	yes
antiproton interaction electromagnetic interaction, antiproton interaction gravity	no
Australia aircraft registration prefix VK, Australia aircraft registration prefix VL	no
New synagogue category for the interior of the item Category:Interior of Zadní synagoga (Třebíč), New synagogue category for the interior of the item Category:Interior of Zadní synagoga (Třebíč) - Frescos	yes
Isfahan economy of topic Economy in Isfahan, Isfahan economy of topic economy of Isfahan	yes
Category:Olympic medalists in fencing list related to category list of male Olympic medalists in fencing, Category:Olympic medalists in fencing list related to category list of Olympic medalists in fencing	yes
Northern Bat original combination Vespertilio nilssonii, Northern Bat original combination Vesperugo nilssonii	yes
Africa topic's main template Template:Countries of Africa, Africa topic's main template Template:Africa topic	yes
ThinkPad GPU Nvidia Quadro, ThinkPad GPU GeForce	no
shimazakiite space group space group P2₁/m, shimazakiite space group space group P2	yes
National Heroes Cemetery in Rwanda category for people buried here Fred Rwigyema, National Heroes Cemetery in Rwanda category for people buried here Agathe Uwilingiyimana	yes
Nobel Peace Prize winner Barack Obama, Nobel Peace Prize winner Carl von Ossietzky	yes
pantoprazole active ingredient in Controloc Control, pantoprazole active ingredient in Pantecta Control	no
tenoxicam significant drug interaction aspirin, tenoxicam significant drug interaction clomipramine	no
Abbasid Caliphate capital Cairo, Abbasid Caliphate capital Hashimiyya	yes
yen currency symbol description 円, yen currency symbol description ¥	yes
Online Database of Tibetan Living Buddhas online access status registration required, Online Database of Tibetan Living Buddhas online access status location restricted to country of publication	yes
S15 state of use proposed building or structure, S15 state of use building or structure under construction	yes
Maria Salome und Maria Cleophae is recto of Circumcision of Jesus, Maria Salome und Maria Cleophae is recto of Die Verkündigung an Maria	yes
Allies of the First World War opposite of Germany, Allies of the First World War opposite of Ottoman Empire	yes
Thelxiepea mother Terpsichore, Thelxiepea mother Sterope	no
square root image of function Riemann sphere, square root image of function set of non-negative real numbers	yes
United States Minor Outlying Islands lowest point Caribbean Sea, United States Minor Outlying Islands lowest point Pacific Ocean	yes
Wario wears shoe, Wario wears cap	no
Tbilisi capital of Georgia, Tbilisi capital of Kingdom of Iberia	no
Colosseum in art category for the exterior of the item Category:Exterior of the Colosseum in art, Colosseum in art category for the exterior of the item Category:Colosseum in art - Exterior	yes
Hastein subject named as Aflengus de Nantouillet, Hastein subject named as Aflingus de  Nantoletium	no
Olympia director of photography Hans Ertl, Olympia director of photography Sepp Ketterer	no
square root image of function complex plane, square root image of function set of non-negative real numbers	yes
Fitil narrator Vladimir Yeryomin, Fitil narrator Vladimir Zaytsev	no
匁 grade of kanji jōyō kanji, 匁 grade of kanji jinmeiyō kanji	yes
Roman Kingdom legislative body Citizens' Assemblies of the Roman Kingdom, Roman Kingdom legislative body Senate of the Roman Kingdom	yes
Dunghutti totem Australian Raven, Dunghutti totem Mantodea	no
Sierra GPU Nvidia Tesla, Sierra GPU Volta	no
Wuhan Huanan Seafood Wholesale Market typically sells snake, Wuhan Huanan Seafood Wholesale Market typically sells Microchiroptera	yes
Sonic Adventure 2 PEGI rating PEGI 3, Sonic Adventure 2 PEGI rating PEGI 7	yes
Midsommar MTRCB rating R-16, Midsommar MTRCB rating R-18	yes
Jessica hair color red hair, Jessica hair color auburn hair	no
Sigurd patronym or matronym for this name Sigurdsson, Sigurd patronym or matronym for this name Sigurdsdatter	no
rhonchi biological phase inspiration phase, rhonchi biological phase expiration phase	no
Narrenzunft Kuckuck motto Narri – Narro, Narrenzunft Kuckuck motto Ho Narro	yes
Alaska lowest point Arctic Ocean, Alaska lowest point Pacific Ocean	yes
Google owner of Google Drive, Google owner of Gears	no
Gustav Ritter von Kahr manner of death capital punishment, Gustav Ritter von Kahr manner of death homicide	yes
square root codomain Riemann sphere, square root codomain complex plane	yes
Super Metroid ESRB rating Everyone, Super Metroid ESRB rating Kids to Adults	yes
Apple M1 Max microarchitecture Apple Icestorm, Apple M1 Max microarchitecture Apple Firestorm	yes
Great Diamond constellation Boötes, Great Diamond constellation Leo	yes
Gliwice Cathedral category for the exterior of the item Category:Exterior of the Gliwice Cathedral at night, Gliwice Cathedral category for the exterior of the item Category:Exterior of the Gliwice Cathedral	yes
RRC 517/4b central bank/issuer Mark Antony, RRC 517/4b central bank/issuer Marcus Cocceius Nerva	yes
Traveller game mechanics procedural generation, Traveller game mechanics lifepath character generation	no
Inigo Montoya handedness ambidexterity, Inigo Montoya handedness right-handedness	yes
Germanicus agnomen Germanicus, Germanicus agnomen Claudianus	no
anxiety measurement scale Karolinska Scales of Personality, anxiety measurement scale Taylor Manifest Anxiety Scale	no
Aranesp therapeutic area anemia, Aranesp therapeutic area chronic renal insufficiency	no
Hastein subject named as Aflingus de  Nantoletium, Hastein subject named as Aflengo Nantolio	no
Russian Socialist Federative Soviet Republic anthem The Internationale, Russian Socialist Federative Soviet Republic anthem Worker's Marseillaise	yes
Japan right to vote age limit, Japan right to vote universal suffrage	no
square root codomain Riemann sphere, square root codomain set of real numbers	yes
Sylheti uses Wikibooks, Sylheti uses Wikinews	no
Kubanochoerus location of discovery Africa, Kubanochoerus location of discovery Eurasia	no
polydipsia suggests the existence of nephrogenic diabetes insipidus, polydipsia suggests the existence of diabetes	no
budget type of unit for this property currency, budget type of unit for this property virtual currency	no
Loviisa Church diocese Diocese of Helsinki, Loviisa Church diocese Diocese of Borgå	yes
American Reunion Hong Kong film rating Category IIB, American Reunion Hong Kong film rating Category III	yes
Bambi art director Dick Kelsey, Bambi art director Al Zinnen	no
1937 Donington Grand Prix fastest lap Manfred von Brauchitsch, 1937 Donington Grand Prix fastest lap Bernd Rosemeyer	yes
1937 Donington Grand Prix fastest lap Bernd Rosemeyer, 1937 Donington Grand Prix fastest lap Manfred von Brauchitsch	yes
Istiqama excluding nifak, Istiqama excluding Kufr	no
Yale University motto Lux et veritas, Yale University motto Urim and Thummim	yes
Enchodus location of discovery Africa, Enchodus location of discovery Colorado	no
Aygün Kazimova category of associated people Alim Qasimov, Aygün Kazimova category of associated people Snoop Dogg	yes
Portuguese language regulatory body Brazilian Academy of Letters, Portuguese language regulatory body Academy of Sciences of Lisbon	no
water phase point critical point, water phase point triple point	no
participant in inverse property participant, participant in inverse property participating team	yes
London twinned administrative body Berlin, London twinned administrative body Moscow	no
Dachstein category for the view from the item Category:Views from Hunerkogel, Dachstein category for the view from the item Category:Views from Dachstein Massif	yes
亇 radical Kangxi radical 6 (⼅), 亇 radical Kangxi radical 4 (⼃)	yes
Frank animal breed beagle, Frank animal breed dachshund	yes
Doryclus Hederich encyclopedia article Doricops, Doryclus Hederich encyclopedia article Doryclvs	no
Michael Jackson: The Experience Australian Classification G, Michael Jackson: The Experience Australian Classification PG	yes
(31384) 1998 XE96 site of astronomical discovery Mérida, (31384) 1998 XE96 site of astronomical discovery Llano del Hato National Astronomical Observatory	yes
mapping dedicated to history, mapping dedicated to Polandball	no
RRC 517/1 central bank/issuer Mark Antony, RRC 517/1 central bank/issuer Marcus Barbatius Pollio	yes
Sri Lanka Bush Warbler original combination Sri Lanka bush-warbler, Sri Lanka Bush Warbler original combination Brachypteryx palliseri	yes
Abseamed therapeutic area anemia, Abseamed therapeutic area chronic renal insufficiency	no
2023 Diriyah ePrix pole position Sébastien Buemi, 2023 Diriyah ePrix pole position Jake Hughes	yes
polydipsia suggests the existence of dipsogenic diabetes insipidus, polydipsia suggests the existence of gestational diabetes insipidus	no
Category:Twelve Imams list related to category The Twelve Imams, Category:Twelve Imams list related to category list of Ismaili imams	yes
Valukarama statement is subject of Valukaramaya, Valukarama statement is subject of Walukarama Maha Viharaya	no
Westfields Infant School Ofsted inspection rating Good, Westfields Infant School Ofsted inspection rating Requires Improvement	yes
Wildspitze parent peak Ortler, Wildspitze parent peak Finsteraarhorn	no
Jin Jian Eight Banner register Manchu Plain Yellow Banner, Jin Jian Eight Banner register Bondservant Division of Plain Yellow Banner	yes
de Miñaur infix space, de Miñaur infix de	yes
Belvedere on the Klausberg state of use ruins, Belvedere on the Klausberg state of use observation tower	yes
Metroid Prime 2: Echoes CERO rating A (All ages), Metroid Prime 2: Echoes CERO rating B (Ages 12 and up)	yes
Aralia castanopsiscola has basionym Pentapanax castanopsicola, Aralia castanopsiscola has basionym Pentapanax castanopsiscolus	yes
square root codomain complex plane, square root codomain Riemann sphere	yes
Merakpa ‎breed belongs to taxon Bos grunniens, Merakpa ‎breed belongs to taxon Bos mutus grunniensis	yes
Leprechaun MAME ROM name leprechn, Leprechaun MAME ROM name potogold	no
Goh has pet Sandile, Goh has pet Ariados	no
pascal measured physical quantity mechanical stress, pascal measured physical quantity bulk modulus	no
People's Republic of China top-level Internet domain .中國, People's Republic of China top-level Internet domain .cn	yes
Mathematica writable file format XML, Mathematica writable file format Keyhole Markup Language	no
Taiwan highest judicial authority Justice of the Judicial Yuan, Taiwan highest judicial authority Supreme Court of the Republic of China	yes
Clayton native label Clayton, Clayton native label Clayton	no
shimazakiite space group space group P2₁/m, shimazakiite space group space group P2₁	yes
Caroline Peters list of works Beautiful Women, Caroline Peters list of works Contergan	yes
French has tense pluperfect, French has tense past participle	no
Quake copyright license GNU General Public License, Quake copyright license shareware	no
We Are the Others RCQ classification 13+, We Are the Others RCQ classification G	yes
vanillin produced by Aspergillus niger, vanillin produced by Psychrobacter	no
HSBC stock exchange New York Stock Exchange, HSBC stock exchange London Stock Exchange	no
rafting associated hazard giardiasis, rafting associated hazard sunburn	no
Australia aircraft registration prefix VN, Australia aircraft registration prefix VI	no
Cooperativa Nacional de Productores de Leche legal form cooperative, Cooperativa Nacional de Productores de Leche legal form Empresa pública no estatal	yes
Primal Fear NMHH film rating Category V, Primal Fear NMHH film rating Category IV	yes
People's Republic of China top-level Internet domain .公司, People's Republic of China top-level Internet domain .cn	yes
Borsele contains settlement Hoedekenskerke, Borsele contains settlement Heinkenszand	no
Matsutake edibility edible mushroom, Matsutake edibility choice mushroom	no
Gansu party chief representative Song Zhaosu, Gansu party chief representative Xian Henghan	no
spaceflight practiced by astronaut, spaceflight practiced by taikonaut	no
John the Baptist and Joachim - Inzigkofen Altar is recto of The Visitation, John the Baptist and Joachim - Inzigkofen Altar is recto of Der Tempelgang Mariae	yes
Himalayan field rat Wildlife Protection Act 1972 (India) schedule Schedule V of Wildlife Protection Act, 1972, Himalayan field rat Wildlife Protection Act 1972 (India) schedule Schedule IV of Wildlife Protection Act, 1972	yes
Korabl-Sputnik 1 space launch vehicle Vostok-L, Korabl-Sputnik 1 space launch vehicle Luna 8K72	yes
Abdal relative to Ghawth, Abdal relative to Qutb	no
Czechoslovakia legislative body National Assembly of the Czechoslovak Socialist Republic, Czechoslovakia legislative body Provisional National Assembly of Czechoslavakia	no
girth less than domination number, girth less than independence number	no
pantoprazole active ingredient in Controloc Control, pantoprazole active ingredient in Pantoloc Control	no
2024 EBSA European Snooker Championship tournament type qualification tournament, 2024 EBSA European Snooker Championship tournament type championship	yes
Thanksgiving foods traditionally associated mashed potato, Thanksgiving foods traditionally associated pumpkin pie	no
mapping dedicated to history, mapping dedicated to war	no
Lycaena alciphron original combination Papilio alciphron, Lycaena alciphron original combination Chrysophanus alciphron	yes
Empire of Brazil flag flag of Brazil, Empire of Brazil flag Flag of the Empire of Brazil	yes
Ixodida natural reservoir of Yezo orthonairovirus, Ixodida natural reservoir of Oz virus	no
German has grammatical mood indicative, German has grammatical mood imperative	no
Enchodus location of discovery Africa, Enchodus location of discovery Alabama	no
Rebellion performer Linkin Park, Rebellion performer Daron Malakian	no
Sylheti uses Wikibooks, Sylheti uses BabelNet	no
Gardens of the Rector’s fountain moved by Sant Climent de Llobregat city council, Gardens of the Rector’s fountain moved by Àmbit metropolità de Barcelona	yes
2005–06 La Liga rules for classification more points, 2005–06 La Liga rules for classification more goals scored	yes
Project 5155 moved by Publicity Department of the Chinese Communist Party, Project 5155 moved by General Administration of Press and Publication	yes
Unitas port of registry Groningen, Unitas port of registry Mariehamn	no
alternation calculated from permutation, alternation calculated from covariant tensor	no
GRB 970508 site of astronomical discovery BeppoSAX, GRB 970508 site of astronomical discovery Ulysses	yes
Category:1562 in Spain category for the view of the item Category:View of Madrid (final drawing), Anthonis van den Wijngaerde, Category:1562 in Spain category for the view of the item Category:View of Madrid (preparatory drawing), Anthonis van den Wijngaerde	yes
Aygün Kazimova category of associated people Snoop Dogg, Aygün Kazimova category of associated people Sinan Akçıl	yes
Deniz literal translation Sea, Deniz literal translation Meer	no
Anastasia Australian Classification G, Anastasia Australian Classification PG	yes
k-minimum spanning tree problem computational complexity NP-hardness, k-minimum spanning tree problem computational complexity APX	yes
Hypoxidaceae has fruit type berry, Hypoxidaceae has fruit type capsule	no
Amphibia main food source Arachnida, Amphibia main food source worm	no
participant in inverse property participating team, participant in inverse property participant	yes
崎 grade of kanji jōyō kanji, 崎 grade of kanji grade 4 kyōiku kanji	yes
2005–06 La Liga rules for classification more points, 2005–06 La Liga rules for classification bigger goal difference	yes
Roxana manner of death capital punishment, Roxana manner of death homicide	no
tetraisocyanatosilane crystal system triclinic crystal system, tetraisocyanatosilane crystal system monoclinic crystal system	yes
MatrizNet statistical unit used work of art, MatrizNet statistical unit used authority file	no
Manx2 Flight 7100 start point Northern Ireland, Manx2 Flight 7100 start point George Best Belfast City Airport	yes
Saraswati domain of saint or deity art, Saraswati domain of saint or deity knowledge	no
Wildspitze parent peak Ortler, Wildspitze parent peak Mont Blanc	no
Dromaeosaurus location of discovery Canada, Dromaeosaurus location of discovery Aguja Formation	no
tetanus possible treatment cardiac glycoside, tetanus possible treatment pharmacotherapy	no
Le Dep RCQ classification G, Le Dep RCQ classification 13+	yes
Draba albertina NatureServe conservation status secure, Draba albertina NatureServe conservation status apparently secure	yes
Maria MTRCB rating R-18, Maria MTRCB rating R-16	yes
The House of the Dead ELSPA rating 11+, The House of the Dead ELSPA rating 3+	yes
One Direction: This Is Us NMHH film rating Category I, One Direction: This Is Us NMHH film rating Category II	yes
kitsch has contributing factor Industrial Revolution, kitsch has contributing factor plastic	no
Artifact takes place in fictional universe Dota 2, Artifact takes place in fictional universe Dota universe	yes
Lake Manzala outflows Suez Canal, Lake Manzala outflows Mediterranean Sea	yes
A2 autostrada state of use proposed building or structure, A2 autostrada state of use building or structure under construction	yes
OpenStreetMap Datahub page openstreetmap, OpenStreetMap Datahub page osm	no
Celastraceae has fruit type berry, Celastraceae has fruit type capsule	no
Korabl-Sputnik 1 space launch vehicle Luna 8K72, Korabl-Sputnik 1 space launch vehicle Vostok-L	yes
Lycaena alciphron original combination Chrysophanus alciphron, Lycaena alciphron original combination Papilio alciphron	yes
Sabena Flight 571 start point Belgium, Sabena Flight 571 start point Brussels Airport	yes
migration may prevent disease inbreeding, migration may prevent disease homozygote	no
The House of the Dead ELSPA rating 15+, The House of the Dead ELSPA rating 11+	yes
Maldives highest point Villingili, Maldives highest point Addu City	no
central bank topic's main template Template:Infobox central bank, central bank topic's main template Template:Central banks	yes
Burlakov case court Panama, Burlakov case court Latvia	yes
Fundamenta Informaticae online access status open access, Fundamenta Informaticae online access status paywall	yes
museum shop typically sells book, museum shop typically sells postcard	yes
Sevastopol legislative body Legislative Assembly of Sevastopol, Sevastopol legislative body Sevastopol Municipality	no
Troy director of archaeological fieldwork Manfred Korfmann, Troy director of archaeological fieldwork Heinrich Schliemann	no
凡 radical Kangxi radical 3 (⼂), 凡 radical Kangxi radical 16 (⼏)	yes
vanillin produced by Bacillus subtilis, vanillin produced by Streptomyces	no
Lrp dual to ytfJ, Lrp dual to adhE	no
Moscow capital of Russia, Moscow capital of Moscow Oblast	no
Sotion time period Roman Empire, Sotion time period Hellenistic period	no
Deniz literal translation Sea, Deniz literal translation Mer	no
Taiwan highest judicial authority Justice of the Judicial Yuan, Taiwan highest judicial authority Judicial Yuan	yes
Paris owner of Eiffel Tower, Paris owner of Paris Bourse	yes
2023 Monza F1 Academy round fastest lap Abbi Pulling, 2023 Monza F1 Academy round fastest lap Marta García	yes
Dunghutti totem Australian Raven, Dunghutti totem Mantodea	yes
Heroes broadcast by NBC, Heroes broadcast by Addik	no
Salzlecken direction east, Salzlecken direction west	no
Icelandic has tense past tense, Icelandic has tense present tense	no
Fitil narrator Artyom Karapetyan, Fitil narrator Vladimir Zaytsev	no
Margraviate of Brandenburg capital Berlin, Margraviate of Brandenburg capital Brandenburg an der Havel	yes
Fitil narrator Vladimir Zaytsev, Fitil narrator Viktoriya Lepko	no
(35678) 1998 XW96 site of astronomical discovery Mérida, (35678) 1998 XW96 site of astronomical discovery Llano del Hato National Astronomical Observatory	yes
Gold Box takes place in fictional universe Forgotten Realms, Gold Box takes place in fictional universe Dragonlance	yes
knapsack problem computational complexity NP-complete, knapsack problem computational complexity NP-hardness	yes
Centre for Eastern European Studies substitute/deputy/replacement of office/officeholder Helena Krasowska, Centre for Eastern European Studies substitute/deputy/replacement of office/officeholder Adam Eberhardt	yes
Loire tributary Divatte, Loire tributary Borne	no
KWrite copyright license GNU General Public License, KWrite copyright license GNU Lesser General Public License	no
human properties for this type image, human properties for this type ethnic group	no
Hesperiinae this zoological name is coordinate with Hesperiidae, Hesperiinae this zoological name is coordinate with Hesperioidea	no
Kingdom of Slavonia legislative body Parliament of Croatia, Kingdom of Slavonia legislative body Parliament of Slavonia	yes
Sweden history of topic Folkunga Dynasty, Sweden history of topic Kingdom of Sweden	no
athletics record or record progression list of African records in athletics, athletics record or record progression list of Olympic records in athletics	no
Kingdom of France capital Paris, Kingdom of France capital Versailles	yes
Tony Hawk's Downhill Jam PEGI rating PEGI 3, Tony Hawk's Downhill Jam PEGI rating PEGI 12	yes
Agworok people economy of topic rice, Agworok people economy of topic maize farming	yes
Lesser bandicoot rat Wildlife Protection Act 1972 (India) schedule Schedule V of Wildlife Protection Act, 1972, Lesser bandicoot rat Wildlife Protection Act 1972 (India) schedule Schedule IV of Wildlife Protection Act, 1972	yes
Abdal relative to Abrar, Abdal relative to Awtad	no
Paris capital of France, Paris capital of Grand Paris	no
Vincent Cassel filmography La Haine, Vincent Cassel filmography Eastern Promises	yes
Bakugan list of characters list of Bakugan Battle Brawlers characters, Bakugan list of characters list of Bakugan	yes
Indiana lowest point Ohio River, Indiana lowest point Wabash River	no
Finland language used French, Finland language used Lingala	no
Elektro has part(s) of the class wheel, Elektro has part(s) of the class electric motor	no
de Vleeschauwer van Braekel infix van, de Vleeschauwer van Braekel infix de	yes
Ravenswood takes place in fictional universe Pretty Little Liars, Ravenswood takes place in fictional universe Pretty Little Liars: The Perfectionists	yes
tenoxicam significant drug interaction aspirin, tenoxicam significant drug interaction methylprednisolone	no
London twinned administrative body Berlin, London twinned administrative body Amsterdam	no
Retacrit therapeutic area cancer, Retacrit therapeutic area chronic renal insufficiency	no
hyperbolic cotangent mathematical inverse hyperbolic tangent, hyperbolic cotangent mathematical inverse inverse hyperbolic cotangent	yes
Gansu party chief representative Yan Haiwang, Gansu party chief representative Wang Sanyun	no
Taiwan highest judicial authority Judicial Yuan, Taiwan highest judicial authority Justice of the Judicial Yuan	no
Balarama incarnation of Vishnu, Balarama incarnation of Shesha	no
Mount Si category for the view of the item Category:Views of Mount Si from Snoqualmie, Mount Si category for the view of the item Category:Views of Mount Si from North Bend	yes
Burlakov case court Panama, Burlakov case court Switzerland	yes
greenalite streak color grayish green, greenalite streak color white	no
aspirin medical condition treated myocardial infarction, aspirin medical condition treated inflammation	no
Korean Empire central bank Bank of Korea, Korean Empire central bank Daiichi Bank	yes
Die Heiligen Georg und Mauritius is verso of Die Heiligen Margareta und Ottilia, Die Heiligen Georg und Mauritius is verso of Die Heiligen Genoveva und Lucia	yes
Carolodarwinia temporal range end Lutetian, Carolodarwinia temporal range end Mustersan	no
malaria possible treatment antipyretic, malaria possible treatment intravenous fluid replacement	no
incineration by-product carbon dioxide, incineration by-product ash	no
Bambi art director Dick Kelsey, Bambi art director McLaren Stewart	no
yen currency symbol description ¥, yen currency symbol description 円	yes
soft-furred rat Wildlife Protection Act 1972 (India) schedule Schedule V of Wildlife Protection Act, 1972, soft-furred rat Wildlife Protection Act 1972 (India) schedule Schedule IV of Wildlife Protection Act, 1972	yes
metronidazole medical condition treated pneumonia, metronidazole medical condition treated bacterial infectious disease	no
Cinderella nickname Cinderella, Cinderella nickname Cendrillon	no
Dunghutti totem Mantodea, Dunghutti totem Australian Raven	no
tetraisocyanatosilane crystal system monoclinic crystal system, tetraisocyanatosilane crystal system triclinic crystal system	no
Bonita copyright license GNU General Public License, Bonita copyright license GNU Lesser General Public License	no
Haapa ‎breed belongs to taxon Bos grunniens, Haapa ‎breed belongs to taxon Bos mutus grunniensis	yes
